SQL文=基本的な命令は4つで構成されるデータベース命令文
SELECT(SQL)=データを取得する命令で、「これ、表示する要素名、FROM、テーブル名」の順で書かれる。テーブル名のテーブルから表示する要素名のデータをすべて取得する。WHEREなどで条件も指定できる。
INSERT(SQL)=データを追加する命令で、「これ、INTO、データを追加したいテーブル名(要素名A、要素名B)、VALUES(要素Aに入れるデータ、要素Bに入れるデータ」の順で書かれる。追加したいテーブル名に追加したい要素を追加する。「これ、INTO SELECT」文という有名な構文がある。
UPDATE(SQL)=データの更新をする命令で、「これ、テーブル名、SET、更新処理」の順で書かれる。追加や削除を行わない場合に使われるが、壊れたデータで更新するとデータベースの破壊を起こす可能性がある。
DELETE(SQL)=データの削除をする命令で、「これ、FROM、テーブル名」の順で書かれる。データベースの破壊を起こす可能性がある。
E-R図=データベース設計で使う設計手法の一つ。データ自体の実体間をボックスと矢印等で示し、各データの関係性を示す。全部で10種類ほどあり、すべてを覚えるのは困難である。
エンティティ=ER図におけるデータのまとまりのこと。これの中にはアトリビュート、という属性情報がある。
アトリビュート=ER図における属性情報のこと。テーブルのタイトルを主キー、内容の属性を外部キーといい、主キーの属性は外部キーの属性によって集まったデータのまとまりであると言える。
リレーション=ER図におけるエンティティ同士の関係を表現する線のこと。
カーディナリティ=ER図におけるリレーションの多重度のこと。1体1，1体多、多対多の3つの関係がある。
チェックイン=変更を加えたファイルをバージョン管理システムのリポジトリに反映する操作のこと
クロスリファレンス=ワープロソフトにおいて、文書内の他の場所にある項目の情報を参照して、任意の場所にその文字列やページ番号などを反映する機能のこと。
グループコミットメント=ネットワークで処理要求が同時に発生した場合に、複数の処理をまとめることでネットワークの負荷を軽減する方法。
サーバプロセスのマルチスレッド=一つのプログラムの処理から、独立した複数の処理を生成し、並行に処理することによって、処理を向上させる機能。
直積=別名をデカルト積といい、数学の集合における単語の一つでもある。各集合から一つずつ元を取りだして、組にしたモノを元として持つ新たな集合のこと。1元配列と1元配列による直方配列となるのが殆ど。
階層モデル=データベースで用いられる構造のモデルの一つであり、データに親子関係を持たせるモデルのことである。
関係モデル=データベースで用いられる構造のモデルの一つであり、テーブルと呼ばれる二次元の表でデータを管理するモデルであり、最も広く利用されているモデルである。データテーブルのタイトルがテーブルの関係をそのまま示す。
ネットワークモデル=データベースで用いられる構造のモデルの一つであり、データを木構造で表現する。子は複数の親を持つことが出来る。
ボイスコット正規化=バラバラなデータベースを関係性によって並べられたきれいなデータベース・管理のしやすいデータベースにかえる課程のこと。非正規形～第5正規形を定義している。
CSMA/CD方式=LANネットワークで用いられる媒体アクセス制御(MAC)方式の一つ。通信路の使用状況を監視し、伝送路の空きを見つけてデータ伝送を行う方式のこと。Ethernetで採用されている。
S/MIME=主な役割はメールの暗号化による盗聴防止とメールへの電子署名。メールの改ざんや送信者のなりすましを防止し、主にフィッシング詐欺対策として利用される。
RARP=Reverse Address Resolution Protocolの略で、TCP/IPネットワーク内で各Ethernetカードの固有のID番号であるMACアドレスからIPアドレスを取得するのに使われるプロトコル。
ARP=Address Resolutioin Protocolの略で、TCP/IPネットワーク内でIPアドレスから各Ethernetカードの固有ID番号であるMACアドレスを取得するのに使われるプロトコル。データリンク層。
PPP=2点間を接続してデータ通信を行うための通信プロトコル。データリンク層。電話回線とのつなぎ目などに使われる。
PPPoE=イーサネットフレーム上にPPPをカプセル化する通信プロトコル。CATVなどでのインターネット接続サービスでのブリッジ接続用に利用される。
SLIP=PPPの先代として使われた。Serial Line Internet Protocolの略。コンピュータに内蔵されたシリアルポートからインターネットなどのTCP/IPに電話回線などの低速回線を通じて一時的に接続するためのプロトコル。チェックサムがないためにデータが破壊されてもデータリンク層で誤りを検出できない。
IPスプーフィング=不正なIPアドレスを用いて攻撃者や攻撃用プログラムを別の人物やプログラムに見せかけること。
NAPT=2つのTCP/IPネットワークの境界にあるルータやゲートウェイが双方のIPアドレスとポート番号を自動的に変換してデータを中継する技術。Network Address Port Translationの略。IPマスカレードとも呼ばれる。
NTP=Network Time Protocolの略で、ネットワーク上の正確時刻同期用プロトコル。
ICMP=Internet Control message Protocolの略であり、通信処理で使われる。何かの命令のタイムアップや宛先到達命令など、制御用のプロトコルである。ping やtracerouteなどがある。ネットワーク層。
SMTP=Simple Mail Transfer Protocolの略。ポート番号25。メールを送信するときのサーバに使われるプロトコル。転送先のサーバを特定するために、DNSのMXレコードが使われる。
VDP=Video Display Processorの略であり、コンピュータの機能ブロックとして映像出力全般を担うプロセッサのことである。
プレゼンテーション層=OSI参照モデルの第6層。暗号化、圧縮などができる。アプリケーション層で行われていることが殆どであり、あまり意識されない。
セッション層=OSI参照モデルの第5層。認証、アクセス権などをサービスするが、その殆どはトランスポート層で行われており、あまり意識されない。
finger=IPアドレスを与え、そのアドレス先のデバイスが持つユーザのログイン名、実名、端末名、権限、アイドル時間、ログイン時間、場所情報、電話番号の表示などをするコマンド。
SNMPトラップ=ポーリングによって情報を取得し、これを送信することで通信障害を把握することが出来る。エージェントがマネージャーに通知を送信する。
ICMP宛先到達不能メッセージ=IPパケットが宛先IPアドレスに到達できなかったときに返されるメッセージ。ネットワーク層。ルータが返すことが多い。
SNMP=ネットワーク監視を行うプロトコル。Simple Network Management Protocolの略。アプリケーション層。ポート162。
NNTP=Network New Transfer Protocolの略。インターネットなどのネットワーク上での記事の投稿や配信、閲覧を行うためのプロトコル。ネットニュースなど。ポート119。
ブロードキャストフレーム=EthernetのLANで用いられる特殊なフレームの一つで、同じネットワークに参加するすべての端末に対して同じ内容の通信を一斉に配信されるもの。自分のアドレスを周囲に知らせるための送信であり、データ伝送には用いない。
PBX=企業等の内部に置かれた電話回線の交換機のこと。内線電話の接続をコントロールするモノ。構内交換機。
ATM(TCP)=Asynchronous Transfer Modeの略。広域通信網で利用される通信プロトコルの一つで、データを53バイトの固定長のセル、という単位で分割して伝送する方式。データリンク層。通信経路を占有しないため、様々な主体が回線網を共用でき、通信効率を高めることが出来る。
共通鍵方式=暗号化と復号化に用いる鍵が同じ方式。受信側で暗号化・復号化用の鍵を作成し、一つを送信者側に送信しておく。DESやAESはこの方式である。
AES=共通鍵方式アルゴリズムのひとつ。換字表による置換、4バイト単位でのビットシフト、ビット演算による行列変換、XOR演算、と単純な処理で構成されるため、高速である。安全性は低いが、意外にどんな攻撃にも屈していない。すごい。
RSA=巨大な桁数の素因数分解問題が解決困難であることを安全性の根拠とした公開鍵暗号方式の一つ。デジタル署名を実現できる方式として最初に公開されたモノ。
ISMS適合性評価制度=組織内での情報の取り扱いについて、一定の水準で機密性、完全性、可用性を確保するための仕組みが、整っていることを認定する制度。
シングルサインオン=一度のユーザ認証処理によって独立した複数のソフトウェアシステム上のリソースが利用可能になる特性。ユーザはシステムごとにユーザIDとパスワードの組を入力する必要がなくなる。
DNSキャッシュポイズニング攻撃=偽のドメインネームをキャッシュサーバにキャッシュさせることで、偽のサイトに誘導し、ドメインの乗っ取りやフィッシング詐欺を図る攻撃手法。
DMZ=インターネットなどの信頼できないネットワークと社内ネットワークなどの信頼できるネットワークの中間に置かれる領域のこと。非武装地帯とも呼ばれる。ファイアウォールはこの部分に実装される。
ブルートフォース攻撃=総当たり攻撃とも呼ばれ、可能な暗号のくみあわせをすべて試すやり方。
パスワードクラック=システムの保存や伝達されるデータからパスワード類推するクラッキング手法のこと。ブルートフォース攻撃と間違われるが、こちらの場合は類推攻撃全般を指すため、最終的にブルートフォース攻撃になる、という方が正確である。
パケットフィルタリング型ファイアウォール=パケットのヘッダを参照してアクセスの許可・禁止を判定する方式。
クロスサイトスクリプティング=掲示板サイトやTwitterなどのようなユーザからの入力内容をWebページに表示するアプリにおいて、ウェブサイトの脆弱性を利用した攻撃方法。基本的には出力されるWebページに悪意のあるスクリプトが埋め込まれている。
CRL=証明書失効リストのこと。有効期限よりも前に失効させたデジタル証明書の一覧。
チャレンジレスポンス認証=認証サーバから特定のキーワードを受け、それを元にパスワードなどを結合して認証サーバに認証して貰う方式による認証。
ElGamal暗号=位数が大きな軍の離散対数問題が困難であることを安全性の根拠とした公開鍵暗号の一つである。巡回群に楕円曲線暗号を用いる。
楕円曲線暗号=楕円曲線状の離散対数問題の困難性を安全性の根拠とする暗号。
DSA=Digital Signature Algorithmの略で、デジタル署名のための情報処理標準である。大体は離散対数問題の困難性に基づく電子署名方式である。
IDEA=DSAの代替えとなる暗号方式。弱い鍵が生成される可能性があるが、無作為に鍵を生成する場合大きな問題にはならない。
LANアナライザ=LAN上を通過するトラフィックを監視したり記録したりするためのハードウェアやソフトウェアのこと。
SAML=Security Assertion Markup Languageの略称であり、インターネットドメイン間でユーザ認証を行うためのXMLをベースにした標準規格。2002年策定。SSO(シングルサインオン)を実現するために使われる仕組みの一つ。
