M/M/1の待ち行列モデル=待ち時間Tを混雑率ρで表したときに「ρ/(1-ρ)」で表されるモデル。ρは稼働パフォーマンスμ、抵抗パフォーマンスλとすると、λ/μで表される。
M/M/1の待ち行列モデルのρ=混雑率
M/M/1野町行列モデルの混雑率の出し方=平均到着/平均サービス
BNF=バッカスナウア記法の略。文字列を曖昧に表現するときの記法一つ。同じようなモノに正規表現などがある。
有限オートマトン=有限個の状態と遷移と動作の組み合わせからなる、プログラムの設計等で用いられるモデルのこと
状態遷移図=有限オートマトンの表現方法の一つで、その振る舞いを直接的に状態をノード、遷移を矢印等で示したもの。
状態遷移表=有限オートマトンによる設計をそのまま表にしたものがこれにあたる。例えば、状態Xで入力Aがあった場合に状態Yに遷移することを示すにはXの列の入力A行に「状態Y」と書かれているような感じ。
UML=統一モデリング言語のこと。
クラス図=システムを構成するオブジェクトを基準に考えた図のこと。UMLの構造図の一つ。
アクティビティ図=システムを構成するフローチャートを基準に考えた図のこと。というかフローチャートそのもの。UMLの振る舞い図の一つ。
ユースケース図=システムの機能をユーザが使用する観点から考えた図のこと。UMLの振る舞い図の一つ。
シーケンス図=時系列に示した図。UMLの相互作用図の一つ。

ハミング符号=行列と行列のかけ算によって1ビットの誤り訂正と2ビットの誤り検出が可能だったりするパリティチェック方法
ポアソン分布=ある期間に平均λ回起こる現象が、別のある期間に平均X回起こる確率の分布。二項分布が元の思考であり、e^-λ・λ^k/k!というしきで表される。(eは自然対数=2.718)
カルノー図=3以上の入力を論理地表にするときに、2入力状態を一辺においてしまうことで簡略化した論理図。考え方が同じで変数の置き方が違うモノにベイチ図がある。
ハッシュテーブル=キーと値の組をエントリと呼び、これを複数個格納してキーに対応する値をすばやく取得するためのデータ構造。
ハッシュ表のデータ衝突=ハッシュテーブルによって生成したキーが、異なる値で同じキーを割り当てたときに起こるモノをこのように呼ぶ。これが発生すると、キーから特定の値を割り当てることが出来ない(割り当てる値が2つ以上があるため)
ヒープソート=二分木構造を利用してソートする方法。制御用データが必要ないため、メモリが限られているときなどに有用。
クイックソート=その名の通りとても早いソート方法(最悪の場合O(n^2)だが)。軸要素を一つとり、それより大きい要素区分と小さい要素区分に分け、それぞれの区分でソートし直し、単種類の要素のみになったら終了、という論理。
B木=ある一定ルールのグループ分けをしたキーによる木で、葉に値を適用したバランス木のこと。データベースなどで用いられる記憶構造論理の一つ。
線形探索=検索のアルゴリズムの一つ。順番に値をチェックし、合致したら処理終了、という単純なモノ。
パイプライン制御=CPUの内部構造をいくつかのステージに分けて、ステージ単位で並行処理する仕組み
ステージ=パイプライン制御における分割単位のこと。命令をこの単位に分ける。
サイクル=パイプライン制御における命令を完了させるのにかかる処理の総数。
メモリインタリーブ=物理上は一つであるディスクなどの領域を、論理的な複数の領域に分割し、並列にアクセスすることで高速化する手法。
スーパスカラ=命令処理を実行する回路を複数実装することで複数個の命令を捌く手法。
セットアソシアティブ=コンピュータ内部のメインメモリとキャッシュメモリの間でデータ格納位置の対応付けを行う方式の一つで、メインメモリのアドレスに一定の計算をすると対応するキャッシュメモリのアドレスにたどり着く、その位置にあるいくつかのブロックにデータを格納する方式。またその領域にキャッシュすること。
フルアソシアティブ=コンピュータ内部のメインメモリとキャッシュメモリの間でデータ格納位置の対応付けを行う方式の一つで、アドレスとは無関係にデータを格納する方式。
ダイレクトマッピング=コンピュータ内部のメインメモリとキャッシュメモリの間でデータ格納位置の対応付けを行う方式の一つで、アドレスからブロックを一意に決定する方式。
ライトスルー=CPUが記憶装置にデータを書き込むと同時にキャッシュに書き込む、キャッシュメモリの動作方式。
ライトバック=CPUが記憶装置にデータを書き込もうとしたときにキャッシュに書き込みを行い、処理時間に余裕があるときにキャッシュメモリから記憶装置へデータを書き込む、キャッシュメモリの動作方式。
SIMD=一つの命令を複数のデータに適用することで並列にデータ処理をすること。ベクトル処理、などとも言う。
グリッドコンピューティング=インターネットなどにある広域な演算資源を結びつけ、一つの複合したコンピュータとしてサービスを提供する仕組みのこと
RISC=コンピュータの命令セットの設計方針の一つ。それぞれの命令を単純化し、命令の総数や種類を減らす方式。真逆の方式にCISCがある。
MIMD=プロセッサーが個別に複数の命令を複数のデータに適用することで並列にデータ処理をすること。
オペランド=コンピュータの演算における値や変数のこと。
ターンアラウンドタイム=システムにデータの要求をしてから結果の出力が終了するまでの時間のこと。
フェールアヴォイダンス=故障や障害が発生しないようにするシステム設計信憑性に対する考え方
フェールソフト=障害が発生したときに機能を制限してでも継続して動作するようにするシステム設計信憑性に対する考え方
フォールトマスキング=障害が発生しているときに別の障害が発生しないようにするシステム設計信憑性に対する考え方
フォールトトレラント=障害が発生しても動作し続けられるようにするシステム設計信憑性に対する考え方
フールプルーフ=ユーザが誤った操作をしても障害が発生しないようにするシステム設計信憑性に対する考え方
指数分布=λe^(-λx)で表される分布。ポアソン分布はこれに近似する。
スプーリング=プリンタやメールサーバなどに出力データを一時的に保存しておくこと。バッファを一枚噛むみたいな感じ。
スループット=機器や通信路が単位時間あたりに出せる処理性能の量のこと。
ベンチマークテスト=特定の負荷を機器や通信路にかけ、その処理時間を測定することでその機器や通信路が出せる処理性能を測ること。
命令ミックス=CPUの処理能力や計算に使用する命令の組み合わせのこと。命令の使用頻度、命令の実行時間などが分かることで処理能力が分かる。
フォールバック=通常使用する機能が故障などで使えなくなったときに、機能を縮小して不完全ながらも動作し続けるために切り替えることや動作し続けること。
オーバレイ=写真や図表の上にかぶせる副次的データを書いた半透明の表示方法
ラウンドロビンスケジューリング方式=CPUにタスクを実行させるときに、一定の制限時間を設け、時間内に終わらなかったら別のタスクへ実行県が移る方式
到着順方式=CPUにタスクを実行させるときに、そのタスクの実行権限が到着した順に実行していく方式。
優先度順方式=CPUにタスクを実行させるときに、タスクの優先度が高いモノから順に実行していく方式。
多重待ち行列方式=ラウンドロビン方式に優先度順方式を重ねた方式

EAI=異なる複数のシステム間のデータ連係をスムーズにする仕組み。Enterprise Application Integrationの略
EJB=サーバ上で動作するアプリケーションをソフトウェア部品を組み合わせて開発・実行できるようにしたモノ。JavaEEが深く関わっている。Enterprise JavaBeansの略。
ERP=Enterprise Resource Planningの略であり、企業経営の基本的資源要素を適切に分配し有効活用する計画のこと
VML=Vector Markup Languageの略であり、Webページ上で線や図などを表記するための言語。
LRUアルゴリズム=Least Recently Usedの略。最も使われていないデータを最初に捨てる方式。
MRUアルゴリズム=Most　Recently Usedの略。最も使われているデータを最初に捨てる方式。
LFU=Least Frequency Usedの略。最も頻度の少ないデータを最初に捨てる方式
インデックス方式=キーを指定することで何かの値を返す方式全般のこと。
B木インデックス=キーを指定することで挿入検索削除が行える木構造の一つ
転置インデックス=全文検索を行う対象となる文書群から単語の位置情報を格納するための索引
ハッシュインデックス=ハッシュ関数に基づいてキーを算出する
アクセシビリティ=近づきやすさ、アクセスのしやすさのこと
ニーモニックコード=コンピュータの命令を人間の理解できる形に表現したコード。
シーケンスコード=連続した値をデータ一つ一つに割り振っていくこと。enumって言えば分かりやすい？
デシマルコード=人が認識できる英数字を十進数で示したコード
コードブロック=プログラムの複数の命令や構文をひとくくりにまとめたもの。
ブロックコード(入れない)=和音の名前のこと。CとかG#とかGm7とか。
メタボール=CG用語。複数のオブジェクトを融合して一つのオブジェクトとなる過程を描くn次元の有機的なオブジェクトを表す言葉。立体を作る素材の球だと思えば良い。
ラジオシティ=光源や間接光源を描画する手法。影の度合い。
レンダリング=データ記述言語やデータ構造言語などの抽象的・高次的表現からプログラムを用いて画像・映像・音声などを生成すること
レイトレーシング=光線の伝搬を物理法則に従ってシミュレートすることで写真のような表現を行う手法
SVG=XMLベースの2次元ベクターイメージコードの1つであり、W3Cによって開発されたコード種。Scalable Vector Graphicsの略
SMIL=World Wide Web上でマルチメディアコンテンツを表現するためのマークアップ言語の1つ。Synchronized Multimedia Integration　Languageの略
w3C勧告=Web技術の標準化を目的とし、W3C規格を扱うW3Cと一般社会のレビューで標準化されたWeb技術文書。
Ajax=非同期通信を行いながらインターフェイスを構築するプログラミング手法であり、HTTP通信をするJavascript組み込みクラスを扱う。
MPEG-1=動画・音声データの圧縮標準規格の一つ。1.5Mbps程度の動画音声のデータ転送を必要とする。
MPEG-2=MPEG-1をもっと圧縮したやつ。あんま変わらん。ちなみにMPEG-3は存在しない。
MPEG-4=MPEG-2をもっと圧縮したやつ
サーフェスモデル=表面だけを定義するモデリング体系のこと。
ワイヤーフレーム=棒状の軸を使って形を作っていくモデリング体系のこと。
ソリッドモデル=形状を定義するモデリング体系のこと。
逆量子化=離散値表にしたデータを元の物理量に戻すこと
標本化=物理量等を一定の時間間隔でデータを取ること
量子化=物理量を整数などに近似した離散値表にすること
符号化=整数値をビット列に直すこと
ロールバック=データ更新などで障害が起きたときに、更新前情報を用いてデータを戻していく作業のこと
正規化=データの重複をなくし、データを整合的に取り扱えるようにしていくこと。追加更新削除などで不整合な用にならないようにするために行う。関係データベースでとても重要な考え方
非正規形=正規化が全く行われてないデータのこと。商品管理データで言う入荷ログの生データとかこんな感じ
第1正規形=繰り返し項目を別レコードとして独立させたデータ。
第2正規形=主キーと非キー属性に分け、一つの主キーで決定する非キー属性を摘出して、そいつらを全部関数的リファレンスに直した表を作り出し、部分関数従属に分けて完全関数従属の状態にしたデータ
第3正規形=非キー属性のうちいくつもの主キーで達成する非キー属性の依存関係をまとめて完全関数従属の状態にしたデータ
第4正規形=
DBMSの原子性=ACID特性と言われる4つの要素の一つ。Atomicityの訳で、これが保証されるというのは、ある2つの処理があり分割できるとして、その処理を呼び出したときに2つの処理が必ず、「実行される」か「実行されない」かのどちらかであることを保証することである。
DBMSの一貫性=データベースのルールが整合性がとれていることを示す。ACID特性で言うところのConsistently
DBMSの独立性=トランザクション中の処理が他から隔離されていることを指す。ACID特性で言うところのIsolation
DBMSの永続性=データベースのシステムが故障しないことを保証すること。ACID特性で言うところのDurability
分散トランザクション処理=ネットワーク上の2つのホストが関連するひとまとまりの操作のことで、トランザクション処理の一つである。
2相コミットプロトコル=分散トランザクションの正しい完了を保証する一般的な方法。EJBやTMSがこれにあたる。ノードトランザクションはコミットされるか失敗されるかの2つしか返してこない。最大の欠点として、待ち状態になってしまうこと。タイムアウトなどで強制ロールバックになりやすい。
調停者=Coordinatorと訳される。コミットできるかどうかを聞く立場であり、応答が合意ならコミットせよメッセージでコミット完了待ちをする。
参加者=Cohortsと訳される。コミットできるかどうかを聞かれる立場であり、応答を合意、もしくは停止で返す。コミットせよメッセージがあればコミットを行い完了次第完了を返す。
フェーズ=コミット要求相とコミット相に分かれている。
メタデータ=索引をするためのあるデータに付随した別のデータのこと。
ストアドプロシージャ=データベースに対する一連の動作をデータベースに保存したモノ。RDBMSでの実装が主。
データディクショナリ=情報システムで使う種類、名前、意味、所在、データ型をまとめた辞書。情報の一貫性のタメに作られる。(人間に理解の出来る言語で作成される)
分散データベース管理システム=ネットワーク上に複数存在するデータベースを1つのデータベース管理システムが制御する形態のこと
集中管理方式=分散データベース管理システムにおいて、単独のサイトにのみ配置して管理する方式。
分散管理方式=分散データベース管理システムにおいて、すべてのサイトに配置して管理する方式。
クラスタリング=多数の低廉なハードウェア・ソフトウェアを用いてあたかも1つの大きなコンピュータであるかのように利用できるようにすること
ミラーリング=一方向同期とも言われ、あるディスクソースからターゲットのディスクにコピーされること。RAID-1の概念。
レプリケーション=あるコンピュータやソフトウェアの管理するデータの集合の複製を別のコンピュータに作成し、通信ネットワークを介してリアルタイムに更新を反映させて常に内容を同期すること。