直流送電系統=送電線のリアクタンスなどによる発電機間の安定度の問題がないため、長距離・大容量送電に有利である。直流磁界に伴う地磁気測定には影響があり、昇圧や降圧が困難である
大地帰路電流=地中埋設物の電食を起こす原因。直流送電系統では特に注意が必要。
1バンク=変圧器のかたまりの単位。単相変圧器2台または3台で三相電圧を昇降圧する場合はそれらのかたまり1つでこの単位になる。電力会社の配電所・変電所では2以上が普通である。
こう長=電柱間における水平距離のこと。
架空地線=架空電線路を、雷から保護する設備となる裸電線。GWと称されることも多い。
架空地線の遮蔽角=一般的に45度以内にするよう設置される。架空地線の直下と送電線とを電柱を正面から見たときの角度のこと。
光ファイバー複合架空地線=架空地線内に光ファイバー線が埋め込まれていること。架空地線よりも細く、エネルギーが弱いために実現可能。
架空送電線の電線=裸より線が用いられており、硬銅より線や鋼心アルミより線が使用される。
硬銅より線=HDCCと呼ばれる。硬銅線を緊密に同心円により合わせたもので、配電線、送電線、絶縁電線の導体として使用される。
鋼心アルミより線=ACSRと呼ばれる。中心に亜鉛メッキ鋼より線を配置し、その周囲に硬アルミ線を同心円状により合わせた電線。
相間スペーサ=強風による電線相互の接近および衝突を防止するため、電線相互の間隔を保持する器具。
がいし=電線と支持物(電柱)との間に取り付ける装置で、両者の間を絶縁する役割を果たす。
懸垂がいし=笠状の磁気絶縁層の両側に連結用金具を設置したがいし。複数個連結して使う。
長幹がいし=中に空洞のない笠付き磁気棒の両端に連結用金具を設置したがいし。1本もしくは数本を連結して使う。
ラインポストがいし=中に空洞のない笠付き磁気棒の一端に固定支持用の金具を接着したがいし。1本で使う。
がいしの要求性能=地絡事故の異常電圧に耐え、機械的な強度が高く、長期間にわたって劣化せず、吸湿せず、安価であること。
アークホーン=がいしの両端に設けられた金属電極のこと。落雷時のフラッシオーバの際生じるアークを電極間に生じさせ、がいしの破壊を防ぐ。直流送電系統の場合は耐アーク性能が十分なら省くことが出来る。
雷サージ=落雷の影響により発生する異常高電圧や異常大電流のこと。
フラッシオーバ=電線に落雷したときに、がいしが破壊されて地絡すること。火花放電ともいう。
逆フラッシオーバ=鉄塔に落雷したときに、鉄塔と大地の間の接地抵抗が高いと、この分のエネルギーが送電線へ伝わってしまう現象のこと。
フラッシュオーバ=瞬間的に燃え広がる火災のこと。引火性のガスが起因で、大爆発する事象のこと。
アークホーン間電圧=アークが起きた際、アークホーン同士に発生する電圧のこと。
多条化=電柱に接続する電線を増やすこと。
二回線送電線路=1つの電柱にある三相交流の電線で送電する単位が2つある電線路のこと。6本の電線が張られる。
コロナ放電=とがった電極の周りに不均一な電解が生じることにより起こる持続的な放電のこと。火花放電よりも先にコチラの放電が必ず起こる。電流は数uA程度であり、集塵機などに応用されている。
アーク放電=電極からの電子の放出が二次電子放出作用以外のものが主となる放電の形態で、最終形態である。低電圧大電流で放電可能であり、このときの温度は10000K(9700℃)を超える。
多導体方式=送電線の導体を同じ電位を持つ2本以上の導体で構成する方式
単導体方式=各相に1条の導体を用いる方式。
不平衡絶縁方式=送電線が2回線平行で電力を供給している場合、落雷によるフラッシオーバ事故が両方の回線に起きると系統全体による影響が大きいので、絶縁強度をあえて変えることで低絶縁側の送電線だけの事故となり、ルート事故を防止する方式。
コロナ損失=コロナ放電によるエネルギー損失のこと。
シース=ケーブルの外皮のこと。
シース損=ケーブルの金属シースに発生する損失。渦電流損がある。ケーブルの発熱となり、ケーブル許容電流を小さくする原因となる。
片単接地方式=シース電圧抑制のためにシースに施す接地方式の一つで、片端をシース接地、他端を開放する方式。回路損は発生しないが、シース電圧が大きい。
ソリッドボンド方式=シースを2カ所以上で接地する方式で、シース電圧は殆ど0であるが、シース回路損が大きい。
クロスボンド接地方式=こう長が長い単身ケーブルで、3区間ごとに接地する方式。3区間でのシース電圧のベクトル和はほぼ0であり、シース回路損も低減できる。
一線地絡事故=三相交流電線のうち、1つの線が地絡する事故のこと。一般的な地絡事故はこれである。
直接接地方式=220kV以上の超高圧系統で採用されている。中性点をそのまま接地することであり、一線地絡事故が発生すると大きな地絡電流が流れる。
高抵抗接地方式=66，154kV程度の高圧系統で採用されている。抵抗Rn[Ω]を介して中性点を接地する方式で、地絡事故電流はこの抵抗の値で決まる。
高抵抗接地方式の地絡事故の電流値=抵抗Rnとすると、I equal 電圧[V] / ( sqrt(3) * Rn )となる。
非接地方式=6.6kV程度の配電系統で採用されている。高い抵抗Rn(10kΩくらい)を介して等価的に中性点を接地する方式。配電線の静電容量Cによって電流が流れるため、配電系統の大きさ、地中配電線の有無などで大きく変化する。
電灯動力共用=200V三相と100V単相の電力を4本の電線を用いて供給する配電方式のこと。YΔ三相4線色変圧器(75kVA以上)と異容量V結線三相4線式(75kVA未満)の2種類がある。
共用変圧器=高圧受電設備において、容量の異なる単相変圧器をV結線し、三相負荷と単相負荷を供給する方式があり、容量の大きい三相負荷と単相負荷とを供給する変圧器のこと。
専用変圧器=高圧受電設備において、容量の異なる単相変圧器をV結線し、三相負荷と単相負荷を供給する方式があり、三相負荷のみを供給する容量の小さい変圧器のこと
交直変換器=交流と直流を変換する装置。高調波や無効電力による対策に、フィルタや調相設備が、自励式・他励式に関わらず必要である。他励式ではサイリスタを用いている。
テブナンの定理=求めたい電流値がある複雑な回路において、求めたい部分を最初に切り離し、求めない部分の電圧と抵抗を求めた後にVo/(Ro+R)で求めたい電流を求める回路変換定理。
逆潮流=自家発電設備を系統連携で運用している場合の電力、または発電電力量をすべて系統に逆走することを言う。売電。
系統連系=固定価格買い取り制度の導入により、一般家庭で発電した電気を電力会社に買い取って貰うケースが増えたため、この際、発電した電気を送るために、電力会社の送配電網に接続すること。
高調波電流=ひずみ波交流の中に含まれている、基本波の整数倍の周波数を持つ正弦波と定義されている電流のひずみのこと。電路や接続機器に悪影響を及ぼす性質がある。適切なフィルタを設けることで抑制することが出来る。
避雷器(SPD)=雷やスイッチの開閉によって発生した瞬間的な過渡的過電圧(サージ)を制限し、機器や設備を保護する機器のこと。
サブスパン振動=電線に付着した氷雪による非対称電線断面の風下にできる「カルマンの渦」の上下交互の交番圧力と、複導体や多導体の1相内のスペーサとスペーサの間隔の間の電線の固有振動数が共振して発生するもの。実測によると振動周波数1～2Hz、全振幅10～50cm程度となる。
コロナ振動=電線表面の電解の強さと付着水分によって、電線下面と垂下状態にある水滴がコロナ放電により電線を蹴って放散するとき、その力の加わる周波数と電線の固有振動数が一致して共振したときに発生する振動。気象条件や架線状態によって著しく左右するが、振動の周波数は1～3Hz、全振幅は9～10cmである。
スパイラルロッド=電線にらせん状に巻かれる線で、着雪を防ぐためのもの。
ダンパ=電線に取り付けるおもりで、微風振動を吸収させるもの。
スリートジャンプ=付着氷雪が脱落するときの電線の跳躍現象。他の振動に見られるような共振振動とは異なり、減衰振動であり、持続性はない。しかし、跳躍が大きいと相間短絡を起こすことがあるため、装柱設計時に電線配列を検討、吟味したり、オフセットを設けたりして事故の発生を防止する必要がある。
ギャロッピング現象=送電線に雪や氷が付着した状態で強風が吹き寄せたとき、送電線が上下に激しく振動する現象のこと。着雪・着氷と風による送電線の自励振動現象であり、上下方向の他に水平方向とねじれ振動を伴う。相間スペーサによって防ぐことが可能。
アーマロッド=クランプで把握された部分の電線が微風による振動により素線切れするのを防ぐために巻き付けられる補強線のこと。電線と同種類の金属でできており、電線振動の応力軽減やアークによる電線の損傷、断線の防止にも使われる。
フェランチ効果=地中送電線のように対地間の静電容量が大きい場合、受電端電圧が送電端電圧よりも上昇する現象。
リアクトル接地方式=架空系統で消弧リアクトル接地方式(地絡電流0)、ケーブル系統で補償リアクトル接地方式をとるために用いられる。
静電誘導障害=送電線と通信線の相互の静電結合によって、通信線に誘導電圧が生じること。
電磁誘導障害=送電線が通信線に接近しているとき、送電線に地絡事故が生じたときの地絡電流により発生した磁界の影響で通信線に起電力が誘導される現象のこと。
誘導障害の対策=電力線と通信線を離す、遮蔽線を設ける、通信線に遮蔽装があるケーブルを採用する、ねん架する、架空地線の条数を多くする、地絡電流を小さくする(高抵抗の接地方式をする)など。
ねん架=交流送電において、架空送電線路の各相のインダクタンスや静電容量の不平衡をなくすために、電線の位置を入れ替えること。
コロナ臨界電圧=コロナ放電が発生する最小の電圧のこと。
プロテクタヒューズ=ネットワーク変圧器二次側に接地されるもので、電力会社変電所の不必要な遮断を防止し、保護協調を行う。
ケッチヒューズ=過電流保護のために設けられ、低圧引き込み線が低圧配電線と分岐するところに用いられる。
高圧カットアウト=過電流保護のために設けられ、柱上変圧器の一次側(高圧側)に設けられる。
プロテクタ遮断機=ネットワーク継電器で制御され、気中遮断機などが用いられる。
