NAS電池=負極にNa、正極にSを用いた二次電池のこと。
浮動充電方式=商用電源が繋がっている間は商用電源から供給して負荷を動かしつつ、並列に接続された二次電池の充電を行い、停電時は二次電池によって負荷に供給するという方式。電源の容量が大きくなりがちだが、瞬断が起こらないメリットがある。
無停電電源装置=停電時でも電力を供給し続ける装置。商用電力から電力を受け取り、電力を蓄積し、一定規格の電力を出力する部分が搭載されている。可変交流の出力をVVVF、固定交流の出力をCVCF(低電圧低周波数電源)という。
分散型電源

1バンク=変圧器のかたまりの単位。単相変圧器2台または3台で三相電圧を昇降圧する場合はそれらのかたまり1つでこの単位になる。電力会社の配電所・変電所では2以上が普通である。
こう長=電柱間における水平距離のこと。
架空地線=架空電線路を、雷から保護する設備となる線。GWと称されることも多い。
架空地線の遮蔽角=一般的に45度以内にするよう設置される。架空地線の直下と送電線とを電柱を正面から見たときの角度のこと。
光ファイバー複合架空地線=架空地線内に光ファイバー線が埋め込まれていること。架空地線よりも細く、エネルギーが弱いために実現可能。
架空送電線の電線=裸より線が用いられており、硬銅より線や鋼心アルミより線が使用される。
硬銅より線=HDCCと呼ばれる。硬銅線を緊密に同心円により合わせたもので、配電線、送電線、絶縁電線の導体として使用される。
鋼心アルミより線=ACSRと呼ばれる。中心に亜鉛メッキ鋼より線を配置し、その周囲に硬アルミ線を同心円状により合わせた電線。
相間スペーサ=強風による電線相互の接近および衝突を防止するため、電線相互の間隔を保持する器具。
がいし=電線と支持物(電柱)との間に取り付ける装置で、両者の間を絶縁する役割を果たす。
懸垂がいし=笠状の磁気絶縁層の両側に連結用金具を設置したがいし。複数個連結して使う。
長幹がいし=中に空洞のない笠付き磁気棒の両端に連結用金具を設置したがいし。1本もしくは数本を連結して使う。
ラインポストがいし=中に空洞のない笠付き磁気棒の一端に固定支持用の金具を接着したがいし。1本で使う。
がいしの要求性能=地絡事故の異常電圧に耐え、機械的な強度が高く、長期間にわたって劣化せず、吸湿せず、安価であること。
アークホーン=がいしの両端に設けられた金属電極のこと。落雷時のフラッシオーバの際生じるアークを電極間に生じさせ、がいしの破壊を防ぐ。
雷サージ=落雷の影響により発生する異常高電圧や異常大電流のこと。
フラッシオーバ=電線に落雷したときに、がいしが破壊されて地絡すること。火花放電ともいう。
逆フラッシオーバ=鉄塔に落雷したときに、鉄塔と大地の間の接地抵抗が高いと、この分のエネルギーが送電線へ伝わってしまう現象のこと。
フラッシュオーバ=瞬間的に燃え広がる火災のこと。引火性のガスが起因で、大爆発する事象のこと。
アークホーン間電圧=アークが起きた際、アークホーン同士に発生する電圧のこと。
多条化=電柱に接続する電線を増やすこと。
二回線送電線路=1つの電柱にある三相交流の電線で送電する単位が2つある電線路のこと。6本の電線が張られる。
不平衡絶縁方式=送電線が2回線平行で電力を供給している場合、落雷によるフラッシオーバ事故が両方の回線に起きると系統全体による影響が大きいので、絶縁強度をあえて変えることで低絶縁側の送電線だけの事故となり、ルート事故を防止する方式。
コロナ放電=とがった電極の周りに不均一な電解が生じることにより起こる持続的な放電のこと。火花放電よりも先にコチラの放電が必ず起こる。電流は数uA程度であり、集塵機などに応用されている。
アーク放電=電極からの電子の放出が二次電子放出作用以外のものが主となる放電の形態で、最終形態である。低電圧大電流で放電可能であり、このときの温度は10000K(9700℃)を超える。
多導体方式=送電線の導体を同じ電位を持つ2本以上の導体で構成する方式
単導体方式=各相に1条の導体を用いる方式。
コロナ損失=コロナ放電によるエネルギー損失のこと。
一線地絡事故=三相交流電線のうち、1つの線が地絡する事故のこと。一般的な地絡事故はこれである。
直接接地方式=220kV以上の超高圧系統で採用されている。中性点をそのまま接地することであり、一線地絡事故が発生すると大きな地絡電流が流れる。
高抵抗接地方式=66，154kV程度の高圧系統で採用されている。抵抗Rn[Ω]を介して中性点を接地する方式で、地絡事故電流はこの抵抗の値で決まる。
高抵抗接地方式の地絡事故の電流値=抵抗Rnとすると、I equal 電圧[V] / ( sqrt(3) * Rn )となる。
非接地方式=6.6kV程度の配電系統で採用されている。高い抵抗Rn(10kΩくらい)を介して等価的に中性点を接地する方式。配電線の静電容量Cによって電流が流れるため、配電系統の大きさ、地中配電線の有無などで大きく変化する。
電灯動力共用=200V三相と100V単相の電力を4本の電線を用いて供給する配電方式のこと。YΔ三相4線色変圧器(75kVA以上)と異容量V結線三相4線式(75kVA未満)の2種類がある。
共用変圧器=高圧受電設備において、容量の異なる単相変圧器をV結線し、三相負荷と単相負荷を供給する方式があり、容量の大きい三相負荷と単相負荷とを供給する変圧器のこと。
専用変圧器=高圧受電設備において、容量の異なる単相変圧器をV結線し、三相負荷と単相負荷を供給する方式があり、三相負荷のみを供給する容量の小さい変圧器のこと
テブナンの定理=求めたい電流値がある複雑な回路において、求めたい部分を最初に切り離し、求めない部分の電圧と抵抗を求めた後にVo/(Ro+R)で求めたい電流を求める回路変換定理。
